1111111111111111111111111111111
1000100000000000000000000000001
10001000C0000000000000000000001
1000000000001100011111100E00001
1000100000011000011111100000001
10C01000001100C0000001100000001
1000100000000000000001100000001
1011100011111100000011000111001
1000000011111100C00000000001001
1000000000001100001111100C01111
10PC00000C0011000111111000010C1
1000000000000000000000000000001
1111111111111111111111111111111
